R 900 675

SO ./textures/brick.xpm
WE ./textures/grey.xpm
NO ./textures/blue.xpm
EA ./textures/wood.xpm

S ./textures/barrel.xpm

F 224,172,105
C 205,249,255

111111              11111
10S0211             12021
12000211            10201
112000211           11111
 112000211
  112000211
   112000211
    112000211
     112000211
      112000211
       112000211
        112000211
         112000211
          112000211
           112000211
            112000211
             112000211
              112000211
11111          112000211
10201           11200021
12021            1122221
11111             111111
