R 675 450

NO ./textures/brick.xpm
SO ./textures/metal.xpm
WE ./textures/stone.xpm
EA ./textures/wood.xpm
S ./textures/barrel.xpm

C 255,255,255
F 0,0,0

	1111111111111111111111111
	1000000000110000000000001
	1011000001110000002000001
	1001000000000000000000001
1111111110110000011100000000000N1
100000000011000001110111122011111
11110111111111011100000010001
11110111111111011101010010001
11000000110101011100000010001
10002000000000001100000010001
10000000000000001101010000001
1100000111010101111101111000111
11110111 1110101 101111010001
11111111 1111111 111111111111
