R 1080 720

SO ./textures/brick.xpm
WE ./textures/grey.xpm
NO ./textures/blue.xpm
EA ./textures/wood.xpm

S ./textures/barrel.xpm

F 224,172,105
C 205,249,255

        1111111111111111111111111
        1000000000110000000000001
        1011000001110000002000001
        100100000000000000E000001
111111111001100000111000000000001
100000000011000001110101110111111
11110111111111011100000010001 
11110111111111011101010010001
11000000110101011100000010001
10002000000000001100000010001
10000000000000000001010000001
11000001110101011111011110001
11110111 1110101 111111010001
11111111 1111111 111111111111
