R 1440 810 

SO ./textures/brick.xpm
WE ./textures/metal.xpm
NO ./textures/stone.xpm
EA ./textures/wood.xpm

S ./textures/barrel.xpm

F 156, 204, 156
C 195, 200, 255

        1111111111111111111111111
        1000000000110000000000001
        1011000001110000002000001
        1001000000000000000000001
111111111101100000111000000000001
100000000011000001110111111111111
11110111111111011100000010001
11110111111111011101010010001
11000000110101011100000010001
10002000000000001100000010001
10000000000000001101010010001
11000001110101011111011110N0111
11110111 1110101 111111010001
11111111 1111111 111111111111
